6 4
\//\\/
\///\/
//\\/\
\/\///
3 3
///
\//
\\\
5 5 
/\/\/ 
\/\/\ 
/\/\/ 
/\/\/ 
\/\/\ 
4 4 
//\\ 
//\\ 
\\// 
\\// 
6 6 
/\/\/\ 
\//\\/ 
///\\\ 
\\\/// 
/\\//\ 
\/\/\/ 
6 4 
/\/\/\ 
\\/\// 
//\/\\ 
\/\/\/ 
6 4 
/\/\/\ 
\\/\// 
//\/\/ 
\/\/\/ 
0 1 

1 0 
75 75 
\\\//\/\\/////\//\\\\\\/\//\\\\//\//////\\\/\//\/\\/\\/\/\//\/\/\\\/\/\\//\ 
//\\\/\/\\\//\/\\\/\/\/\\\/\/\/\\//\/\\\/\\/\/\//\\/\///////\//\/\\///\/\\/ 
/\\//\///\\\\/////\//\/\///\\\\/\//\/\\/\\\\\\/\////\\\\//\\////\/\\\/\/\\\ 
\\\//\\\/\\/\/\/\\/\/\\\\/\\\\//\\\/\/\\/\\\\\\\\/\\/\////\\//\\\//\/\///\\ 
/\\//\/\/\/\\\//\/\/\\/\\/\\\\\//\\/\\///\\/\\\///\\//\\///\//////\\//\/\\/ 
\\\\\//\\\\/\\/\///\\/\/\\/\///\////\/\\\/\\/\/\/\\\/\\\\/////\\\\//\\\\//\ 
\///\/\/\\//\\\\/\\\\//\/\//\\/\///\\\\\\\/\\\\/\/\\\//\\/\\//\///\/\\\//\/ 
\\/\\//////\//\\/\/\\\\\\//\\\\//\//\//\/\/\/\/\\//\\/\///\//\\\\\/\\//\\\\ 
//\\/\//\\//\//\//\/\\///\\/\/\////\\/\\///\////\/\\///\\/\///\\\\//\\/\/// 
\//\////\///\\\\\\\///\//\/\///\\/\/\\\\///\\\/\\\///\\\/\\//\\/\\/\//\/\\\ 
/\\//\\///\\\\\\///\////\///\/\/\\\//\\/\\/\////\/\\/\/\////\/\/\\/\/\/\/\/ 
/\/\\\\\/\\/\/\\/\\///\\//\//\/\//\//\////////\////\\/\\\\\\\///\\////\\/\\ 
/\//\\/\\\/\\/\//\\\\\/\\\////\//\\/\\\\\\\/////\\\////\/\\//\/\\\\\/\//\\\ 
\/\\/\//\\\//\/\\\/\\///\\\\\\\\/\\\//\\\///\\\/\\\/\\\\\\/\/\\/\/\/\/\/\/\ 
//\\//\\/\\//\\\\///\\\\\\\/\\///\\//\///\//////\/\//\/\\\\/\\/\//\\/\/\/// 
\\/\/\//\/\//\\///\\\\\/\///////////\///\\/\/\//\/\///\/\\\/\/\\/\\\\\/\\/\ 
///\\\\///\/\//\\\\\/\/\\\\///\\\/\\\\\\\\\\///\\\\\/\///\\/\/\///\\\\\\/\/ 
\//\\\\\/\////\\\/\\\/\\\\/\/\//\////\\//\//////\/\//\\/\///\/\/\\///\\///\ 
/\\/\\\\\\\\\\\\//\\\///\///\\/\\\\///\////\\///\//\/////\\\//\//\\/\\\/\\/ 
//\/////\\/\\\\/\\\/\\//\\\\\//////\//\\/\////\///\\\\//\////\/\/\/\///\//\ 
//\\\\\/\//\//\\\\\\///\\\/\/\////\/\/\\\\\/\///\/\\\///\\//\\\/\/\\//\/\/\ 
\\/\\\/\\//\///\\//\\\\\\/\/\\///////\/\//\\\/\\////\\\\\/\\\/\\/\/\////\\\ 
/\\//\\\\/\/\/\\/\\/\/\\///\////\\\//\/\\//\\/\///\/\\//\\/\////\//\\/\\\\\ 
\\/\//\\///\/\/\//\//\\\\\//\/\\/\/\//\\///////////////\/\\/\\\/\\\\/\\/\// 
//\//\////\///\/\/\/\///\\//\\/\\//\//\\/\//\/\/\//\\\\\\///\/\\\\\\//\/\\/ 
\\//\//\\//\\/\\\\/\\\\\/\\/\\//\/\\\/\//\\\///\\/\\\/\\//\\/\\/\///\/\\\/\ 
/\//\//\/\\\/\\///\\\/\\/\/\\///\\\\///\//\/\\\\///\\\\/\\/\\\/\///\/\\\//\ 
\//\\//\///\/\/\\\\/\\/\\\\\\////\\\\/\\\///\\/\\/\\\\\\/\//\\/\\//\/\//\// 
//\\\/\///\/\\\\\/\\//\////\\//\\//\/\//\\/////\\\/\\\/////\\//\/\/\\\/\\\/ 
//\/\\/////\\\\\\////\\\\/\\/\//\/\\//\\\//\/\///\\/\\\\//\///\//\///\/\\\/ 
//////\/\///\\\///////\\\/\/\\//\\\//\\\\\\/////\//\/\/////\\//\\/\/\/\/\/\ 
/\/\///\\//\///\\\\\/\\/\\////\/\/\/\//\//\\///\///\\/\/\/\/\\\\//\/\\\//\\ 
\\/\/\//\\\//\\//\///\\\/\\//\///\/\////\/\/\\\/\//\\\///\/\/\\/\///\\\///\ 
\//\//\\/\///\/\/\\/\/\\\\///\\/////\/\\///////////\/\\\\/\\\\\/\/////\///\ 
/\///\\\////\\\\/\/\\\///\//\\\\\\/\///\\//\//////\\/\\/\\\/\\\\\\/\//\\/// 
\/\////\/\///\\///\///\\\/\\\/\/\\/\/\\\\/\\\\/////\\\\////\///\\\/\///\\// 
/\\//////\/\////\/\///\\\/\///\\\\//////\\/////\/\////\\/\/////\\//\//\\/\\ 
/\/\/\\///\\\\///\\//\/\/\/\////\//\//\\/\//\//\/\////\/\////\\/\//\\\\\/\\ 
/\\\\\/\/\/\/\\\/\\\//\\/\\/////\/\/\\//\\/\/\//\/\/\\////\//\//\/\\/\\\/\\ 
\\/\\\/\/\\\/\\\////////\\//\\/\///\/\/\////\//\\/\\\\\\\\//\\\\/\\\\\\/\// 
//\/\/\//\/\/\/\\/\/\\/\\\/\//\//////\//\\\\\\\///\\/\//////\\/\\////\\\\/\ 
////\/\\/\\///\\\\///\/\//\\/\/\//\\/\//\/\\/\//////\//\/////\/\\\/\\/\\/\\ 
//\/\//\\/\//\/\\\\//\\//\/\//\\\///\//\\\///\\\\/\\//\\\\//\//\\\\/\\/\\/\ 
/\\\\////\\//\\\/\\\\\///\\\\\/\\\\\///\\\/\//\\\\//\\/\///////\/\//\\///// 
//\\\\\\/\/\\/\\\/\/\\\\//\//\\/\\\\/\/\\\/\//\/\/\/\\\////\/\\///\/\/\//\\ 
///\/\///\\/\\/\/\/\///\//\///\////\\//\\/\/\//\\\////\////\////\\\\/\\///\ 
\\\//\//\\\\\//\//\\////\//\\///\/\/\\\/\//\/\\\//\\\/\\\\//\\/\//\//\///// 
\/\\\\\\\\\/\//\\\/\\\\\/\\\/\\/\/\/\/\/\\\\/////\//\\\/\\\\\\/\\/\\\\\\/\/ 
//\/////\/\/\\///////\\//\\\\\\////\\////\/\//\///\\\\//\/\\\\\\\//\/\\\\// 
\\/\/\\\//\//\\\//\/\\\\/\\/\\///////\///\\/\\\/\///\\///////\\\/\\\\\\\\// 
\\//\/\//\\//\\//\\\\\\/\\\/\/\\/\\\\\//\\\\/\/\//\//\///\\\\/\\//\////\\\/ 
/\\/\/\//\//\\\/\//\\/\/\\\\\\/\\//\/\\/\\///\/\\\//\\//\\/\\\\////\//\\/// 
///\\\\/\/\\\\/\\///\\\//\/\//\//\\\//\\///\////\/\//\\\///\//////\\\\\/\\\ 
/\\\/\////\///\\\\///\\\\/\/\\\\\/\//\\/\\//////\\\\\/\\/\//\///\\/\\\/\\\/ 
\\\//\\\\\\/\\\//\\//\//\/\\//\\\////\\/\/\/\\/\\\///\///\/\\/\\\/\/\//\//\ 
\/\\\/////\\////\////\\\//\\/\\/\/\\\/\/\/\/\/\///\////\\\///\\//\/\/\//\\/ 
//\/\///\\//\/\\////\///\\/\////\/\///\\\//\//////\\\\\/\\/\\\/\\/\\\\\/\// 
//\/\//\\/\///\\/\\///\///\//\/\\//////\//\\\\/\///////\\\////\\/\//\//\//\ 
//\\\/\\/\/\/\\/\/\/\//\\\/\//\//\\\\/\//\\\\\\/\////\\\/\\\/\\//\//\/\\\// 
\/\\/\\\\/\//\/\\/\/\\\//\\\\/\//\\/\/\\\\\///\\\\\/\\\/\/\\/\\\\\\/\/\/\/\ 
\\///\/\/\///\/\\\\\/\\/\//////\/\///\/\/\\/\/\\//\/\//\//\\\\/\\\\///\/\/\ 
/\/\/\\\\/\///\\/\/\\/\/\\\\/\/\/\//\\\\\/////\//\\//\\/\\\///\\\//\\\/\\\\ 
/\\\\//\///\//\/////\/\\/////\/\/\\\\/\\//\//\\\\\/\////\\\\/\\/\////\\\//\ 
\/\/\///\//\\\\\/\\\\\///\//\\////\\\\\/\/////\\\/\\//\\\///\///\//\///\\\/ 
\///\\\////\/\\/\/\\//\/\////\\\\/\\\/\\/\\\\\\\//\\////\/\\\\\\///\//\/\// 
/\/\//\///\//////\\\/\\/\///\/\/\//\\/\/\\////\\\\\\/\/\\\//\/\\/\\\/\//\\\ 
/\\//\\\//////\\/\\///\/\/\\/\/\////\\/\\\/\\//////////\///\/\\/\\\/\\\\/\/ 
///\//\/\\//\/\//\//\///////\\\//\\\\//\/\/\\//\\/\//////\\\\\\\///\/\\/\// 
\\///\/\\\/\//\///\\\\\\/\\\\/\\/\\//\/\\\/\\\/\/\//\///\\///\/\///\////\/\ 
\////\\////\\/\\\/\/\///\///\//\/\/\\/\/\/\\\///\\\\\///\/\\\/\\/\/\\\/\//\ 
\\\/\/\\////\\///\//\\\\/\/\\\//\//\////\/\//\/\\\\\/\//\/\//////\\/\\//\\\ 
\////\\\/////\\\//\\\\//\\\\//\\/\\\\//\/\/\\\\/\///\//\\//\\\\//\/\//////\ 
\\\\\//\\\/\\/\////\\//\\//\/\/\/\/////\\/\\//\///\\/\//\\\\\\\///\/\//\/\\ 
/\/\\//\//\/\\\/////\\\/\\\//\//\////\\///\/\//\\\\\/\/\//////\\/\\/\\/\/// 
\/\//\//\//\\///\\\//\\////////\\\\//\//\//\\\/\\///\/\/\/\///\/\////\/\\\/ 
5 5 
//\\\ 
///\\ 
\\\\\ 
/\\// 
\\\// 
0 0
